25 20
  #######################
  #.....................#
  #.....................#
  #.....................#
  #.....................#
  #.....................#
  #.....................#
  #...#..#..###..#...#..#
  #...#..#.#...#.#...#..#
  #....##..#...#.#...#..#
  #....#...#...#.#...#..#
  #....#....###...###...#
  #.....................#
  #.....................#
  #.....................#
  #.....................#
  #.....................#
  #.....................#
  #..@..................#
  #######################
